5x9
XXXXXXXXX
E.......X
XXXXXXX.X
G.......X
XXXXXXXXX