9x9
XXXXXXXXX
E.......X
XXXXXXX.X
G.XXXXX.X
X.XXXXX.X
X.XXXXX.X
X.XXXXX.X
X.......X
XXXXXXXXX