7x8
XGXXXXXX
G.X....X
XX..X.XG
E..X...X
XXXX.XXG
G....X.G
XXXXXXXX