7x7
XXXXXXX
X.....X
XX.X.XX
E...X.G
X.X...X
X...X.X
XXXXXXX